20,39.
000000000000000000000000000000000000000
GGGGGGGGGGGGGGGGGGGGGGGGGGGGGGGGGGG0000
G000000E000000000E000000000E000000G0000
G000000E0000C0000E0000C0000E00000>G0000
G000000E000000000E000000000E000000G0000
G000000E0000E0000E0000E0000E000000G0000
G00000000000E0000C0000E00000000000G0000
G00BBBBBBBBBBBBBBBBBBBBBBBBBBBBBBBG0000
G000000000000000000000000000000000G0000
GB000000000000000C0000000000000000G0000
GB00000000000000000000000000000000G0000
GBB00000000000000E0000000000000000G0000
GBB000000E0000000E00000000E0000000G0000
GBBBBBBBBBBBBBBBBBBBBBBBBBBBBBB000G0000
G000000000000000000000000000000000G0000
G00000000000000000000000000000000BG0000
G000000000C00000000000C000000000BBGGGGG
G0P00000000000000000000000000000000000G
G000000E00000E00000E00000E000000000000G
GGGGGGGGGGGGGGGGGGGGGGGGGGGGGGGGGGGGGGG