00000000000000000000000000000000000
GGGGGGGGGGGGGGGGGGGGGGGGGGGGGGGGGGG
G000000E000000000E000000000E000000G
G000000E0000C0000E0000C0000E00000>G
G000000E000000000E000000000E000000G
G000000E0000E0000E0000E0000E000P00G
G00000000000E0000C0000E00000000000G
G00BBBBBBBBBBBBBBBBBBBBBBBBBBBBBBBG
G000000000000000000000000000000000G
GB000000000000000C0000000000000000G
GB00000000000000000000000000000000G
GBB00000000000000E0000000000000000G
GBB000000E0000000E00000000E0000000G
GBBBBBBBBBBBBBBBBBBBBBBBBBBBBBB000G
G000000000000000000000000000000000G
G00000000000000000000000000000000BG
G000000000C00000000000C0000000000BG
G0000000000000000000000000000000BBG
G000000E00000E00000E00000E000000BBG
GGGGGGGGGGGGGGGGGGGGGGGGGGGGGGGGGGG