20,70.
0000000000000000000000000000000000000000000000000000000000000000000000
0000000000000000000000000000000000000000000000000000000000000000000000
0000000000000000000000000000000000000000000000000000000000000000000000
0000000000000000000000000000000000000000000000000000000000000000000000
0000000000000000000000000000000000000000000000000000000000000000000000
0000000000000000000000000000000000000000000000000000000000000000000000
0000000000000000000000000000000000000000000000000000000000000000000000
0000000000000000000000000000000000000000000000000000000000000000000000
000000000000000000000G000000000000000000000000000000000000000000000000
0000000000000000000000000000000000000000000000000000000000000000000000
0000000000000000000000000000000000000000000000000000000000000000000000
0000000000000000000000000000000000000000000000000000000000000000000000
0000000000000000000000000000000000000000000000000000000000000000000000
GGGGGGGGGGGGGGGGGGGGGGGGGGGGGGG000000000000000000000000000000000000000
G000000000000000000000000000000000000000000000000000000000000000000000
G00000000000000G000000000000000000000000000000000000000000000000000000
G000000000000000000000000000000G000000000000000000000G0000000000000>00
G000000000000000000000000000000G00000000000000G000000G0000000000000000
G0P0000000000000000000000000E00G00000000000000G000000G0000000000000000
GGGGGGGGGGGGGGGGGGGGGGGGGGGGGGGGGGGGGGGGGGGGGGGGGGGGGGGGGGGGGGGGGGGGGG