20,140.
00000000000000000000000000000000000000000000000000000000000000000000000000000000000000000000000000000000000000000000000000000000000000000000
00000000000000000000000000000000000000000000000000000000000000000000000000000000000000000000000000000000000000000000000000000000000000000000
00000000000000000000000000000000000000000000000000000000000000000000000000000000000000000000000000000000000000000000000000000000000000000000
00000000000000000000000000000000000000000000000000000000000000000000000000000000000000000000000000000000000000000000000000000000000000000000
G0000000000000000000000000000000000000000000000000000000000000000000000000000000000000000000000000000000000000000000000000000000000000000000
G00000000000000000000000000GGGGGGGGGGG00000000000000000000000000000000000000000000000000000000000000000000000000000GGGGGGGGGGGGGG00000000000
G00000000000000GGGGGGG000000000000000000000000000000000000000000000000000000000000000000000000GGGGGGGGGGGGGGGGGGGGGG000000000000000000000000
G0000000000000000000000000000000000000000000000000000000000000000000000000000000000000000000000000000000000000000000000000000000000000000000
G000000000000000000000000000000000000000GGGGGGGGGG0000000000000000000000000GGGGGGGGGGGGGGGG0000000000000000000000000000000000000000000000000
G0C000000000000000000000000000000000000000000000000000000000000000000000000GGGGGGGGGGGGGGGG0000000000000000000000000000000000000000000000000
GGGGGGGGGG000000000000000000000000000000000000000000000000000000000000000GGGG000000000000000000000000000000000000000000000000000000000000000
G0000000000000000000000000GGGGGGGGGGG000000000000000000000000000000000000GGGG000000000000000000000000000000000E0E0E0E0E0E0E0E000000000000000
G0000000000000000000000000000000000000000000000000000000000000000000000GGGG00000000000000000000000000000000000GGGGGGGGGGGGGGGGGGG00000000000
G0000000000000000000000000000000000000000000000000000000000000000000000GGGG00000000000000000000000000C00000000000000000000000000000000000000
G000000000000000000GGGG0000000000000000000000000000000000000000000000GGGG0000000000000000000000000GGGGGG000000000000000000000000000000000000
G00000000000000000000000000000000000000000000000000000000000000000000GGGG0000000000000000000000000G0000000000000000000000000000000000000000G
G0000000000000000000000000000000000000000000000000000000000000000000000000000000000000000000000000G000000000000000000000000000000000000000>G
G000000000000000000000000GG0000GG0000GG0000GGGGGGGGGGGGGGGGGGGGGGGG0000000000000000000000000000000G0000000000000000000000000000000000000000G
G00P0000000000E0000000000GGEEEEGGEEEEGGEEEEG0C0E000000000000000000000000000000000000000EEEEEEEEEEEGEEEEEEEEEEE00000000000000000000000000000G
GGGGGGGGGGGGGGGGGGGGGGGGGGGGGGGGGGGGGGGGGGGGGGGGGGGGGGGGGGGGGGGGGGGGGGGGGGGGGGGGGGGGGGGGGGGGGGGGGGGGGGGGGGGGGGGGGGGGGGGGGGGGGGGGGGGGGGGGGGGG