00000000000000000000000000000000000
GGGGGGGGGGGGGGGGGGGGGGGGGGGGGGGGGGG
G000000EEE000EEE000EEE000EEE000000G
G000000EEE0C0EEE0C0EEE0C0EEE00000>G
G000000EEE000EEE000EEE000EEE000000G
G000000EEE000EEE000EEE000EEE000000G
GC0000000000000000000000000000000EG
G00BBBBBBBBBBBBBBBBBBBBBBBBBBBBBBBG
G000000000000000000000000000000000G
GB00000000000000C00000000000000000G
GB000000000000C000C000000000000000G
GBB0000000000000000000000000000000G
GBBC0EEE00EEE00EEE00EEE00EEE00000CG
GBBBBBBBBBBBBBBBBBBBBBBBBBBBBBB000G
G00000000000000000000000000000BB00G
G00000000000000000000000000000000EG
G00000000000000000000000000000000BG
G0P000E0000E0000E0000E0000E00000BBG
G00000E00C0E00C0E00C0E00C0E0000BBBG
GGGGGGGGGGGGGGGGGGGGGGGGGGGGGGGGGGG