20,35.
00000000000000000000000000000000000
GGGGGGGGGGGGGGGGGGGGGGGGGGGGGGGGGGG
G00000000E0000000E0000000E00000000G
G00000000000000000000000000000000>G
G00000000C0000000C0000000C00000000G
G000000000000000000000000000000000G
G00000000E0000000E0000000E00000000G
G00BBBBBBBBBBBBBBBBBBBBBBBBBBBBBBBG
G000000000000000000000000000000000G
GB00000000000000000000000000000000G
GB000000EE000C00000C00EE0000000000G
GBB0000000000000E00000000000000000G
GBB00000000E0000E00000000E00000000G
GBBBBBBBBBBBBBBBBBBBBBBBBBBBBBB000G
G000000000000000000000000000000000G
G00000000000000000000000000000000BG
G0000000000000000C000000000000000BG
G0000000000000000000000000000000BBG
G0P000EE000000000000EE0000000000BBG
GGGGGGGGGGGGGGGGGGGGGGGGGGGGGGGGGGG