20,140.
00000000000000000000000000000000000000000000000000000000000000000000000000000000000000000000000000000000000000000000000000000000000000000000
00000000000000000000000000000000000000000000000000000000000000000000000000000000000000000000000000000000000000000000000000000000000000000000
00000000000000000000000000000000000000000000000000000000000000000000000000000000000000000000000000000000000000000000000000000000000000000000
00000000000000000000000000000000000000000000000000000000000000000000000000000000000000000000000000000000000000000000000000000000000000000000
G0000000000000000000000000000000000000000000000000000000000000000000000000000000000000000000000000000000000000000EE0000000000000000000000000
G0000000000000000000000000GGGGGGGGGGGG000000000000000000000000000000000000000000000000000000000GGGGGGGGGGGGGGGGGGGGGGGGGGGGGGGGGG00000000000
G00000000000000GGGGGGG0000000000000000000000000000000000000000000000000000000000000000000000000EEEEEEEEEEEEE00000000000000000000000000000000
G0000000000000000000000000000000000000000000000000000000000000000000000000000GGGGGGGGGGGGGGGGGGGGGGGGGGGGGGG00000000000000000000000000000000
G000000000000000000000000000000000000000GGGGGGGGGG0000000000000000000000000GGGG0000000000000000000G00000000000000000000000000000000000000000
G0C000000000000000000000000000000000000000000000000000000000000000000000000GGGG0000000000000000000G00000000000000000000000000000000000000000
GGGGGGGGGG000000000000000000000000000000000000000000000000000000000000000GGGG000000000000000000000G00000000000000000000000000000000000000000
G0000000000000000000000000GGGGGGGGGGGG00000000000000000000000000000000000GGGG000000000000000000000G00000000000000000000000000000000000000000
G0000000000000000000000000000000000000000000000000000000000000000000000GGGG00000000000000000000000G00000000000E00EE00EE00EE000E0000000000000
G0000000000000000000000000000000000000000000000000000000000000000000000GGGG00000000000000000000000G00C00000000GGGGGGGGGGGGGGGGGGGG0000000000
G000000000000000000GGGG0000000000000000000000000000000000000000000000GGGG0000000000000000000000000GGGGGGG00000000000000000000000000000000000
G00000000000000000000000000000000000000000000000000000000000000000000GGGG0000000000000000000000000G0000000000000000000000000000000000000000G
G0000P0000000000000000000000000000000000000000000000000000000000000000000000000R000000000000000000E000000000000000000000000000000000000000>G
G000000000000000000000000GG0000GG0000GG0000GGGGGGGGGGGGGGGGGGGGGGGG0000000000000000000000000000GGGGGGG0000000000000000000000000000000000000G
G0000000000000E0000000000GGEEEEGGEEEEGGEEEEG0C0E000000000000000000000000000000000000000EEEEEEEEEEEEEEEEEEEEEEE00000000000000000000000000000G
GGGGGGGGGGGGGGGGGGGGGGGGGGGGGGGGGGGGGGGGGGGGGGGGGGGGGGGGGGGGGGGGGGGGGGGGGGGGGGGGGGGGGGGGGGGGGGGGGGGGGGGGGGGGGGGGGGGGGGGGGGGGGGGGGGGGGGGGGGGG