20,140.
G000000000000000000000000000000000000000000000000000000000000000000000000000000000000000000000000000000000000000000000000000000000000000000G
G0000000000000000000000000000000000000000E0000000000000EEEEEEEEEEEEEE0000000000000000000000000000E00000000GGGGGGGGGGGGGG0000000000000000000G
G0000000000000000000000000000000000000000E0000000000000EEEEEEEEEEEEEE0000000000000000000000000000000000000GGGGGGGGGGGGGG0000000000000000000G
G0000000000000000000000000000000000000000E0000000000000EEEEEEEEEEEEEE0000000000000000000000000000000000000GGGGGGGGGGGGGG00000C0000000000000G
G0000000GGGGG0000000EEEEEEEEEEEEE0000000000000000EE00000000000000000000000EE00000EE00000E00000000E00000000EE0000EE0000EE0000000000000000000G
G00000000000GGGGGGGGGGGGGGGGGGGGGGGGGGGGGGGGGGGGGGGGGGGGGGGGGGGGGGGGGGGGGGGGGGGGGGGGGGGG0GGGGGGGGGGGGGGGGGGGGGGGGGGGGGGGGGGGGGGG00000000000G
G00000000000G0000000000000000000000000000000000000000000000000000000000000000000000000000000000000000000000000000000000000000000000000000GGG
GGGGG0000000G0000000000000000000000000000000000000000000000000000EEEEEEEEEEEEEEEE000000000000000000000000000000000000000000000R0000GGG000G0G
G00000000000G000000GGGGGGGGGGGGGGGGGGGG000000000000000000000000000000000C00000000000000000000000000000000000000000000000000GGGGGG00G0G000G0G
G00000000000G00000000000000E00000000000000000000000000000000000GGGGGGGGGGGGGGGGGGG00000000000000000000000000000000000000000G0000G00G0G000G0G
G0000000GGGGG00000000000000E0000000000000000000000000000000000GG00000000000000000G0000000000000000000000000000000000000000EEEEEEEEEEEEEEEEEG
G00000000000GGGGG0000000000E000000000000000000000000000000000GG000000000000000000GGGG0000000GGGGGGGGGGGGGG00000000000000GGGGGGGGGGGGGGGGGGGG
G00000000000G00000000000000E00000000000000000000000000000000GG0000000000000000000000000000GGG00000000000GGG00000000000000000000000000000000G
GGGGG0000000G00000000000000E0000000000000000000000000000000GG0000000000000000000000000000000000000000R000GGG0000000000000000000000000000000G
G00000000000G0C00000GGGGGGGGGGGGGGG00000000000000000000000GG0000000000000000000000000000000000000000000000GGG000000GGGG00000000000000000000G
G00000000000G0000000G0000000000000G00000000000GGGGGGGGGGGGGG00000000000000000000000000000000000GGGGGGGGGGGGGGG0000GG00G00000000000000000000G
G0000000GGGGGGGGGGGGG0000000000000GGGGG0000000EEEEEEEEEEEEEE0000000000000000000000000000000000000000000000000000000000GGGG0000000000000000>G
G000P0000000G000000000000000000000000000000000EE0000EE0000EE000000000000000GGGGG00000GGGGGGG00000000000000000000000000G00000000000000000000G
G00000000000GEEEEEEEEEEEEEEEEEEEEEEEEEEEEEEGGGGGGGGGGGGGGGGGGGGGGGGGGGEEEEEEEEEEEEEEEEEEEEEEEEEEEEEEEEEEEEEEEEEEEEEEEEG00000000000000000000G
GGGGGGGGGGGGGGGGGGGGGGGGGGGGGGGGGGGGGGGGGGGGGGGGGGGGGGGGGGGGGGGGGGGGGGGGGGGGGGGGGGGGGGGGGGGGGGGGGGGGGGGGGGGGGGGGGGGGGGGGGGGGGGGGGGGGGGGGGGGG