11111111111111111111111111111111111
10000000000000000000000000000000001
10000000000000000000000000000000001
10000000000000000000000000000000001
10000000000000000000000000000000001
10000000000000000000000000000000001
10000000000000000000000000000000001
10011111111111111111111111111111111
10000000000000000000000000000000001
10000000000000000000000000000000001
11000000000000000000000000000000001
10000000000000000000000000000000001
10000000000000000000000000000000001
11111111111111111111111111111110001
10000000000000000000000000000000001
10000000000000000000000000000000001
10000000000000000000000000000000011
10000000000000000000000000000000001
10000000000000000000000000000000001
11111111111111111111111111111111111