20,140.
00000000000000000000000000000000000000000000000000000000000000000000000000000000000000000000000000000000000000000000000000000000000000000000
G0000000000000000000000000000000000000000E0000000000000EEEEEEEEEEEEEE0000000000000000000000000000E00000000GGGGGGGGGGGGGG0000000000000000000G
G0000000000000000000000000000000000000000E0000000000000EEEEEEEEEEEEEE0000000000000000000000000000000000000GGGGGGGGGGGGGG0000000000000000000G
G0000000000000000000000000000000000000000E0000000000000EEEEEEEEEEEEEE0000000000000000000000000000000000000GGGGGGGGGGGGGG00000C0000000000000G
G0000000GGGGG000000000EEEEBBEEEE000000000000000EBE000000000000000000000000BB00000BB00000E00000000E00000000EE0000EE0000EE0000000000000000000G
G00000000000GGGGGGGGGGGGGGGGGGGGGGGGGGGGGGGGGGGGGGGGGGGGGGGGGGGGGGGGGGGGGGGGGGGGGGGGGGGG0GGGGGGGGGGGGGGGGGGGGGGGGGGGGGGGGGGGGGGG00000000000G
G00000000000G0000000000000000000000000000000000000000000000000000000000000000000000000000000000000000000000000000000000000000000000000000GGG
GGGGG0000000G0000000000000000000000000000000000000000000000000000EEEEEEEEEEEEEEEE000000000000000000000000000000000000000000000R0000GGG000G0G
G00000000000G000000GGGGGGGGGGGGGGGGGGGG000000000000000000000000000000000C00000000000000000000000000000000000000000000000000GGGGGG00G0G000G0G
G00000000000G00000000000000E00000000000000000000000000000000000GGGGGGGGGGGGGGGGGGG00000000000000000000000000000000000000000G0000G00G0G000G0G
G0000000GGGGG00000000000000E0000000000000000000000000000000000GG00000000000000000GGGG000000000000000000000000000000000000GGGEEEEEEEEEEEEEEEG
G00000000000GGGGG0000000000E000000000000000000000000000000000GG00000000000000000000000000000GGGGGGGGGGGGGG00000000000000GGG000000000000000GG
G00000000000G00000000000000E00000000000000000000000000000000GG0000000000000000000000000000GGG00000000000GGG00000000000000000000000000000000G
GGGGG0000000G00000000000000E0000000000000000000000000000000GG0000000000000000000000000000000000000000R000GGG0000000000000000000000000000000G
G00000000000G0C00000GGGGGGGGGGGGGGG00000000000000000000000GG0000000000000000000000000000000000000000000000GGG000000GGGG0000000000000000000>G
G00000000000G0000000G0000000000000G00000000G00GGGGGGGGGGGGGG00000000000000000000000000000000000GGGGGGGGGGGGGGG0000GG00G00000000000000000000G
G0000P00GGGGGGGGGGGGG0000000000000G00000000G00EEEEEEEEEEEEEE0000000000000000000000000000000000000000000000000000000000GGG0000GGG00000000000G
G00000000000G000000000000000000000GGG000000G00EE0000EE0000EE000000000000000GGGGG00000GGGGGGG00000000000000000000000000G000000GGG00000GGGGGGG
G00000000000GEEEEEEEEEEEEEEEEEEEEEEEEEEEEEEGGGGGGGGGGGGGGGGGGGGGGGGGGGEEEEEEEEEEEEEEEEEEEEEEEEEEEEEEEEEEEEEEEEEEEEEEEEGBBBBBBBBBBBBBBGGGGGGG
GGGGGGGGGGGGGGGGGGGGGGGGGGGGGGGGGGGGGGGGGGGGGGGGGGGGGGGGGGGGGGGGGGGGGGGGGGGGGGGGGGGGGGGGGGGGGGGGGGGGGGGGGGGGGGGGGGGGGGGGGGGGGGGGGGGGGGGGGGGG