20,140.
00000000000000000000000000000000000000000000000000000000000000000000000000000000000000000000000000000000000000000000000000000000000000000000
00000000000000000000000000000000000000000000000000000000000000G0000000EE0000000000000000000000000000000000000000000000000000000000000000000G
00000000000000000000000000000000000000000000000000000000000000G0000000GG000000EE000000EE000000000000000000000000000000000000000000000000000G
GGG00000000000000000000000000000000000000000000000000000000000G0000000EE000000GG000000GG00000000000000000000000000000000000000000000000000>G
GCE0000000000000000000000000000000000000000000000000EEE0000000E000000000000000EE000000EE000000000000000000000000000000000000000000000000000G
GGGGGG00000GGGG0000GGGG0000GGGG00000GGGGGGGGGGGGGGGG000GGGGGGGGGG0000GGGG0000000000000000000000000000000000000000000000000000000000000EE000G
G0000000000000000000000000000000000000000000000000000000000000000000000000000GGGG0000GGGG0000GGGGGGGGGGGGG00000GGGGGGGGGGGGGGGGGGGGGGG00GGGG
G00000000000000000000000000000000000000000000000000000000000000000000000000000000000000000000000000000GGGGGG0000000000000000000000000000000G
G00000000000000000000000000000000000000000000000000000000000000000000000000000000000000000000000000000GG00GGGG00000000000000000000000000000G
G0000000000000000000000000000000000000000000000GGGGGGGGGGGGGGGGGGGGGGG00000000000000000000000000000000GG0000GGGG000000000000000000000GGGG00G
G0000000000000000000000000000000000000000000000E00E00E00E0R0E00E00E00E000000000000000000000000E0000000GG000000GGGG0000000000000000000000000G
G000000000000000000000000GGGGGGGGGGG0000000GGGGGGGGGGGGGGGGGGGGGGGGGGGGGGGGGGGGGG0000GGGGGGGGG0GGGGGGGGG000000000000000GGGGGG00000000000000G
G000000000000000000000000GGGGGGGGGGG0000000GGGGGGGGGGGGGGGGGGGGGGGGGGGGGGGGGGGGGG0000GGGGGGGGG0GGGGGGGGG0000000000000GGGGGGGG0000000GGGGGG0G
G0000000000000000000000GGGG0000000000000000GG00000000000000000000000000000000GG0000000GG00000000000000GG00000000000GGGGGG000000000000000000G
G0000000000000000000000GGGG00000000000000GGGG0C000000000000000000000000000000GG0000000GG00000000000000GG000000000GGGGGG00000000000000000000G
G00000000000000000000GGGGGG000R0000000000GGGGGGGGGGGGGGGGGGGGGGGGGGGGGGG00000GG0000000GG000000C0000000EE0000000GGGGGG000000000R0000GGGGGGGGG
G00000P00000000000000GGGGGG000000000GG00000EE0000EE0000EE0000EE0000EE00000000GG0000000GGGGGGGGGGGGGGGGGGGGGGGGGGGGG0000000000GGG00000000000G
G000000000000000000GGGGGGGG000000000GG0000000000000000000000000000000000000GGGG0000000GGGGGGGGGGGGGGGGGGGGGGGGGGG00000000000000000000000000G
G000000000000000000GGGGGGGG000000000GG00000000EE0000EE0000EE0000EE000000000GGGGEEEEEEEEEEEEEEEEEEEEEEEEEEEEEEEEEEEEEEEEEEEEEEEEEEEEEEEEEEEEG
GGGGGGGGGGGGGGGGGGGGGGGGGGGGGGGGGGGGGGGGGGGGGGGGGGGGGGGGGGGGGGGGGGGGGGGGGGGGGGGGGGGGGGGGGGGGGGGGGGGGGGGGGGGGGGGGGGGGGGGGGGGGGGGGGGGGGGGGGGGG