GGGGGGGGGGGGGGGGGGGGGGGGGGGGGGGGGGG
G000000000000000000000000000000000G
G000000000000000000000000000000000G
G000000000000000000000000000000000G
G0000000000000000C0000000000000000G
G000000000000000000000000000000000G
G000000000000000000000000000000000G
G00BBBBBBBBBBBBBBBBBBBBBBBBBBBBBBBG
G000000000000000000000000000000000G
G000000000000000000000000000000000G
GB00000000000000000000000000000000G
G000000000000000000000000000000000G
G000000000000000000000000000000000G
GBBBBBBBBBBBBBBBBBBBBBBBBBBBBBB000G
G000000000000000000000000000000000G
G00000000000000000000E000000000000G
G00000000000000000000000000000000BG
G00P000000000000000000000000000000G
G000000000000000000000000000000000G
GGGGGGGGGGGGGGGGGGGGGGGGGGGGGGGGGGG