00000000000000000000000000000000000
GGGGGGGGGGGGGGGGGGGGGGGGGGGGGGGGGGG
G000000000000000000000000000000000G
G00000000000000000000000000000000>G
G000000000000000000000000000000000G
G000000000000000000000000000000000G
GC00000000000000000000000000000000G
G00BBBBBBBBBBBBBBBBBBBBBBBBBBBBBBBG
G000000000000000000000000000000000G
GB00000000000000000000000000000000G
GB00000000000000C00000000000000000G
GBB0000000000000000000000000000000G
GBB00EEE00EEE00EEE00EEE00EEE00000CG
GBBBBBBBBBBBBBBBBBBBBBBBBBBBBBB000G
G000000000000000000000000000000000G
G0000000000000000000000000000000EBG
G0000000000C000000000C00000000000BG
G0P000E0000E0000E0000E0000E00000BBG
G00000E0000E0000E0000E0000E00000BBG
GGGGGGGGGGGGGGGGGGGGGGGGGGGGGGGGGGG