00000000000000000000000000000000000
GGGGGGGGGGGGGGGGGGGGGGGGGGGGGGGGGGG
G000000EE0000EE0000EE0000EE0000000G
G00000000000000000000000000000000>G
G000000000000000C0000000000000P000G
G000000000000000000000000000000000G
G000000000EE0000EE0000EE0000EE0000G
G00BBBBBBBBBBBBBBBBBBBBBBBBBBBBBBBG
G000000000000000000000000000000000G
GB000000C00000000000C0000000000000G
GB00000000000000000000000000000000G
GBB0000000000000000000000000000000G
G0000BB0000BB0000BB0000BB0000BB000G
GEEEEEEEEEEEEEEEEEEEEEEEEEEEEEE000G
G0000000000000000C0000000000000000G
G00000000000000000000000000000000BG
G00000000000000000000000000000000BG
G0000000000000000000000000000000BBG
G000000000000000000000000000000EBBG
GGGGGGGGGGGGGGGGGGGGGGGGGGGGGGGGGGG